//MAP CONVERTED BY dmm2tgm.py THIS HEADER COMMENT PREVENTS RECONVERSION, DO NOT REMOVE
"ad" = (
/obj/machinery/mecha_part_fabricator,
/turf/open/floor/plating/reinforced/airless,
/area/shuttle/phoenix/ert)
"bS" = (
/obj/machinery/computer/operating,
/turf/open/floor/pod/light,
/area/shuttle/phoenix/ert)
"dk" = (
/obj/machinery/door/airlock/highsecurity{
	name = "Left Engine Maintenance"
	},
/obj/effect/mapping_helpers/airlock/access/any/admin/general,
/obj/machinery/atmospherics/pipe/smart/manifold4w/supply/visible/layer4,
/obj/effect/mapping_helpers/airlock/cutaiwire,
/turf/open/floor/mineral/plastitanium/red,
/area/shuttle/phoenix/ert)
"do" = (
/turf/template_noop,
/area/shuttle/phoenix/ert)
"dr" = (
/obj/machinery/atmospherics/pipe/smart/manifold4w/supply/visible/layer4,
/turf/open/floor/plating/reinforced/airless,
/area/shuttle/phoenix/ert)
"dy" = (
/obj/item/storage/medkit/frontier/phoenix/stocked{
	pixel_x = 6;
	pixel_y = 8
	},
/obj/item/storage/medkit/frontier/phoenix/stocked{
	pixel_x = -6;
	pixel_y = 8
	},
/obj/structure/table/reinforced,
/obj/item/storage/medkit/frontier/phoenix/stocked{
	pixel_y = 2
	},
/turf/open/floor/pod/light,
/area/shuttle/phoenix/ert)
"dE" = (
/obj/machinery/atmospherics/components/unary/vent_pump/on/layer4{
	dir = 4
	},
/turf/open/floor/pod/light,
/area/shuttle/phoenix/ert)
"eo" = (
/obj/structure/rack/shelf,
/obj/item/ammo_box/magazine/recharge/plasma_battery{
	pixel_y = -6;
	pixel_x = 6
	},
/obj/item/ammo_box/magazine/recharge/plasma_battery{
	pixel_y = -6;
	pixel_x = -6
	},
/obj/item/ammo_box/magazine/recharge/plasma_battery{
	pixel_y = 6;
	pixel_x = 6
	},
/obj/item/ammo_box/magazine/recharge/plasma_battery{
	pixel_y = 6;
	pixel_x = -6
	},
/turf/open/floor/pod/light,
/area/shuttle/phoenix/ert)
"eG" = (
/turf/closed/wall/r_wall,
/area/shuttle/phoenix/ert)
"eU" = (
/obj/machinery/flatpacker,
/turf/open/floor/plating/reinforced/airless,
/area/shuttle/phoenix/ert)
"fq" = (
/obj/machinery/computer/mech_bay_power_console{
	dir = 4
	},
/turf/open/floor/plating/reinforced/airless,
/area/shuttle/phoenix/ert)
"gt" = (
/obj/machinery/atmospherics/pipe/smart/manifold4w/supply/visible/layer4,
/obj/machinery/atmospherics/pipe/smart/manifold4w/scrubbers/visible/layer2,
/obj/effect/landmark/ert_shuttle_spawn,
/turf/open/floor/mineral/plastitanium,
/area/shuttle/phoenix/ert)
"gE" = (
/obj/machinery/atmospherics/components/unary/vent_pump/on/layer4{
	dir = 4
	},
/obj/machinery/atmospherics/pipe/smart/manifold4w/scrubbers/visible/layer2,
/turf/open/floor/pod/light,
/area/shuttle/phoenix/ert)
"gG" = (
/obj/machinery/computer/camera_advanced{
	dir = 1
	},
/turf/open/floor/pod,
/area/shuttle/phoenix/ert)
"gW" = (
/obj/structure/table/reinforced,
/obj/item/storage/box/fragnades,
/turf/open/floor/pod/light,
/area/shuttle/phoenix/ert)
"hZ" = (
/obj/structure/table/abductor,
/obj/machinery/atmospherics/pipe/smart/manifold4w/scrubbers/visible/layer2,
/obj/item/language_manual/tradecreole,
/turf/open/floor/mineral/plastitanium,
/area/shuttle/phoenix/ert)
"ih" = (
/obj/structure/girder/reinforced,
/turf/open/floor/plating/reinforced/airless,
/area/shuttle/phoenix/ert)
"ir" = (
/obj/machinery/atmospherics/pipe/smart/manifold4w/supply/visible/layer4,
/obj/machinery/atmospherics/pipe/smart/manifold4w/scrubbers/visible/layer2,
/turf/open/floor/pod/light,
/area/shuttle/phoenix/ert)
"iB" = (
/obj/machinery/atmospherics/components/unary/vent_scrubber/on/layer2{
	dir = 4
	},
/turf/open/floor/pod,
/area/shuttle/phoenix/ert)
"iP" = (
/obj/structure/curtain,
/obj/machinery/atmospherics/pipe/smart/manifold4w/scrubbers/visible/layer2,
/turf/open/floor/pod/light,
/area/shuttle/phoenix/ert)
"jp" = (
/obj/item/storage/medkit/frontier/phoenix/toxin/stocked{
	pixel_x = 6;
	pixel_y = 8
	},
/obj/item/storage/medkit/frontier/phoenix/toxin/stocked{
	pixel_x = -6;
	pixel_y = 8
	},
/obj/machinery/atmospherics/pipe/smart/manifold4w/scrubbers/visible/layer2,
/obj/structure/table/reinforced,
/obj/item/storage/medkit/frontier/phoenix/toxin/stocked{
	pixel_y = 2
	},
/turf/open/floor/pod/light,
/area/shuttle/phoenix/ert)
"jF" = (
/turf/open/floor/plating/reinforced/airless,
/area/shuttle/phoenix/ert)
"jV" = (
/obj/machinery/atmospherics/pipe/smart/manifold4w/scrubbers/visible/layer2,
/turf/open/floor/mineral/plastitanium,
/area/shuttle/phoenix/ert)
"kC" = (
/obj/machinery/atmospherics/pipe/smart/manifold4w/supply/visible/layer4,
/turf/open/floor/mineral/plastitanium/red,
/area/shuttle/phoenix/ert)
"lv" = (
/obj/structure/chair/comfy/shuttle{
	dir = 1
	},
/obj/effect/landmark/ert_shuttle_brief_spawn,
/turf/open/floor/mineral/plastitanium,
/area/shuttle/phoenix/ert)
"lP" = (
/obj/machinery/portable_atmospherics/pump,
/turf/open/floor/plating/reinforced/airless,
/area/shuttle/phoenix/ert)
"ml" = (
/obj/machinery/mech_bay_recharge_port{
	dir = 2
	},
/turf/open/floor/plating/reinforced/airless,
/area/shuttle/phoenix/ert)
"mo" = (
/obj/structure/flatpack_cart,
/turf/open/floor/plating/reinforced/airless,
/area/shuttle/phoenix/ert)
"mp" = (
/obj/item/storage/bag/sheetsnatcher/debug{
	pixel_x = -6;
	pixel_y = 2
	},
/obj/item/multitool{
	pixel_y = -5;
	pixel_x = 7
	},
/turf/open/floor/plating/reinforced/airless,
/area/shuttle/phoenix/ert)
"mA" = (
/obj/machinery/computer/mech_bay_power_console{
	dir = 8
	},
/turf/open/floor/plating/reinforced/airless,
/area/shuttle/phoenix/ert)
"mB" = (
/obj/machinery/atmospherics/components/tank/air/layer4{
	dir = 1
	},
/turf/open/floor/plating/reinforced/airless,
/area/shuttle/phoenix/ert)
"mE" = (
/obj/structure/lattice,
/turf/template_noop,
/area/template_noop)
"nn" = (
/obj/structure/table/reinforced,
/obj/item/storage/lockbox/loyalty{
	pixel_y = 4
	},
/turf/open/floor/pod/light,
/area/shuttle/phoenix/ert)
"nv" = (
/obj/machinery/door/airlock/hatch{
	name = "Armory Storage"
	},
/obj/machinery/atmospherics/pipe/smart/manifold4w/supply/visible/layer4,
/obj/effect/mapping_helpers/airlock/cutaiwire,
/obj/machinery/atmospherics/pipe/smart/manifold4w/scrubbers/visible/layer2,
/turf/open/floor/pod/light,
/area/shuttle/phoenix/ert)
"nP" = (
/obj/structure/chair/comfy/shuttle{
	dir = 8
	},
/obj/machinery/atmospherics/pipe/smart/manifold4w/supply/visible/layer4,
/obj/effect/landmark/ert_shuttle_spawn,
/turf/open/floor/mineral/plastitanium,
/area/shuttle/phoenix/ert)
"nW" = (
/turf/open/floor/pod/light,
/area/shuttle/phoenix/ert)
"ok" = (
/obj/machinery/computer/centcom_announcement{
	dir = 1;
	command_name = "Phoenix Collective ERT"
	},
/turf/open/floor/pod,
/area/shuttle/phoenix/ert)
"oO" = (
/obj/machinery/portable_atmospherics/canister/anesthetic_mix,
/turf/open/floor/pod/light,
/area/shuttle/phoenix/ert)
"oX" = (
/obj/machinery/atmospherics/pipe/smart/manifold4w/supply/visible/layer4,
/turf/open/floor/pod/light,
/area/shuttle/phoenix/ert)
"pm" = (
/turf/closed/wall/r_wall/plastitanium/nodiagonal,
/area/shuttle/phoenix/ert)
"pT" = (
/obj/machinery/portable_atmospherics/scrubber,
/turf/open/floor/plating/reinforced/airless,
/area/shuttle/phoenix/ert)
"ql" = (
/obj/machinery/atmospherics/pipe/smart/manifold4w/scrubbers/visible/layer2,
/turf/open/floor/plating/reinforced/airless,
/area/shuttle/phoenix/ert)
"qX" = (
/obj/structure/tank_holder/anesthetic,
/turf/open/floor/pod/light,
/area/shuttle/phoenix/ert)
"rd" = (
/obj/vehicle/sealed/mecha/gygax/dark/loaded,
/turf/open/floor/iron/recharge_floor,
/area/shuttle/phoenix/ert)
"rj" = (
/obj/structure/table/reinforced/plasmarglass,
/turf/open/floor/mineral/plastitanium,
/area/shuttle/phoenix/ert)
"rp" = (
/obj/machinery/atmospherics/components/unary/vent_pump/on/layer4{
	dir = 1
	},
/turf/open/floor/pod,
/area/shuttle/phoenix/ert)
"ru" = (
/obj/machinery/space_heater,
/turf/open/floor/plating/reinforced/airless,
/area/shuttle/phoenix/ert)
"rN" = (
/turf/closed/wall/r_wall/plastitanium,
/area/shuttle/phoenix/ert)
"st" = (
/obj/structure/table/reinforced,
/obj/item/storage/toolbox/mechanical{
	pixel_y = 10
	},
/obj/item/storage/toolbox/electrical{
	pixel_y = 2
	},
/obj/item/stock_parts/power_store/cell/infinite/nif_cell{
	pixel_x = 5;
	pixel_y = 2
	},
/turf/open/floor/plating/reinforced/airless,
/area/shuttle/phoenix/ert)
"sT" = (
/obj/machinery/door/airlock/highsecurity{
	name = "Right Engine Maintenance"
	},
/obj/effect/mapping_helpers/airlock/access/any/admin/general,
/obj/effect/mapping_helpers/airlock/cutaiwire,
/turf/open/floor/mineral/plastitanium/red,
/area/shuttle/phoenix/ert)
"tk" = (
/obj/effect/spawner/structure/window/survival_pod,
/obj/machinery/atmospherics/pipe/smart/manifold4w/scrubbers/visible/layer2,
/turf/open/floor/plating,
/area/shuttle/phoenix/ert)
"tv" = (
/obj/effect/spawner/structure/window/survival_pod,
/turf/open/floor/plating,
/area/shuttle/phoenix/ert)
"tQ" = (
/obj/machinery/computer/camera_advanced/shuttle_docker/phoenix/ert{
	dir = 1
	},
/turf/open/floor/pod,
/area/shuttle/phoenix/ert)
"uj" = (
/obj/structure/table/abductor,
/obj/machinery/atmospherics/pipe/smart/manifold4w/scrubbers/visible/layer2,
/turf/open/floor/mineral/plastitanium,
/area/shuttle/phoenix/ert)
"uk" = (
/obj/structure/table/survival_pod,
/obj/item/clothing/mask/breath/muzzle,
/obj/item/disk/surgery/debug{
	name = "Omni Surgery Disk";
	desc = "A disk that contains all existing surgery procedures. Not to be shared with station crews under any circumstance."
	},
/obj/item/healthanalyzer/advanced,
/turf/open/floor/pod/light,
/area/shuttle/phoenix/ert)
"uG" = (
/obj/machinery/cell_charger_multi,
/obj/structure/table/reinforced,
/turf/open/floor/mineral/plastitanium,
/area/shuttle/phoenix/ert)
"vp" = (
/obj/structure/chair/comfy/shuttle{
	dir = 4
	},
/obj/machinery/atmospherics/pipe/smart/manifold4w/scrubbers/visible/layer2,
/obj/effect/landmark/ert_shuttle_spawn,
/turf/open/floor/mineral/plastitanium,
/area/shuttle/phoenix/ert)
"vP" = (
/obj/machinery/atmospherics/pipe/smart/manifold4w/supply/visible/layer4,
/turf/open/floor/mineral/plastitanium,
/area/shuttle/phoenix/ert)
"wb" = (
/obj/machinery/portable_atmospherics/canister/oxygen,
/turf/open/floor/pod/light,
/area/shuttle/phoenix/ert)
"xl" = (
/obj/structure/closet/emcloset/wall{
	pixel_y = 32
	},
/turf/open/floor/mineral/plastitanium,
/area/shuttle/phoenix/ert)
"xt" = (
/obj/structure/chair/comfy/shuttle{
	dir = 8
	},
/obj/machinery/atmospherics/pipe/smart/manifold4w/scrubbers/visible/layer2,
/obj/machinery/atmospherics/pipe/smart/manifold4w/supply/visible/layer4,
/obj/effect/landmark/ert_shuttle_spawn,
/turf/open/floor/mineral/plastitanium,
/area/shuttle/phoenix/ert)
"xC" = (
/obj/structure/rack/gunrack,
/turf/open/floor/pod/light,
/area/shuttle/phoenix/ert)
"zB" = (
/obj/machinery/sleeper/self_control,
/turf/open/floor/pod,
/area/shuttle/phoenix/ert)
"zM" = (
/obj/machinery/computer/shuttle/phoenix/ert{
	dir = 1
	},
/turf/open/floor/pod,
/area/shuttle/phoenix/ert)
"Af" = (
/obj/structure/curtain,
/turf/open/floor/pod/light,
/area/shuttle/phoenix/ert)
"Aw" = (
/obj/machinery/atmospherics/pipe/smart/manifold4w/supply/visible/layer4,
/obj/machinery/atmospherics/pipe/smart/manifold4w/scrubbers/visible/layer2,
/turf/open/floor/mineral/plastitanium,
/area/shuttle/phoenix/ert)
"Ax" = (
/obj/machinery/atmospherics/pipe/smart/manifold4w/scrubbers/visible/layer2,
/turf/open/floor/mineral/plastitanium/red,
/area/shuttle/phoenix/ert)
"Bf" = (
/obj/structure/table/reinforced,
/obj/item/storage/medkit/robotic_repair/preemo/stocked{
	pixel_y = 12
	},
/obj/item/storage/medkit/robotic_repair/preemo/stocked{
	pixel_y = 4
	},
/turf/open/floor/pod/light,
/area/shuttle/phoenix/ert)
"Bi" = (
/obj/machinery/atmospherics/components/unary/vent_scrubber/on/layer2{
	dir = 4
	},
/turf/open/floor/pod/light,
/area/shuttle/phoenix/ert)
"BR" = (
/obj/machinery/door/airlock/highsecurity{
	name = "Shuttle Bridge"
	},
/obj/effect/mapping_helpers/airlock/access/any/admin/captain,
/obj/effect/mapping_helpers/airlock/unres,
/obj/effect/mapping_helpers/airlock/cutaiwire,
/turf/open/floor/mineral/plastitanium/red,
/area/shuttle/phoenix/ert)
"CT" = (
/obj/structure/table/optable,
/obj/machinery/defibrillator_mount/charging{
	pixel_y = 22
	},
/obj/item/defibrillator/loaded{
	pixel_y = 6
	},
/turf/open/floor/pod/light,
/area/shuttle/phoenix/ert)
"Di" = (
/obj/machinery/button/door/directional/north{
	normaldoorcontrol = 1;
	specialfunctions = 4;
	id = s;
	name = "Exterior Bolt Control";
	pixel_x = 5
	},
/turf/open/floor/mineral/plastitanium,
/area/shuttle/phoenix/ert)
"Dt" = (
/obj/machinery/atmospherics/components/unary/vent_pump/on/layer4{
	dir = 8
	},
/obj/machinery/atmospherics/pipe/smart/manifold4w/scrubbers/visible/layer2,
/turf/open/floor/pod/light,
/area/shuttle/phoenix/ert)
"DK" = (
/obj/machinery/door/airlock/highsecurity{
	name = "Armory Bridge Access"
	},
/obj/effect/mapping_helpers/airlock/access/any/admin/captain,
/obj/effect/mapping_helpers/airlock/cutaiwire,
/obj/machinery/atmospherics/pipe/smart/manifold4w/scrubbers/visible/layer2,
/turf/open/floor/mineral/plastitanium/red,
/area/shuttle/phoenix/ert)
"DT" = (
/obj/machinery/atmospherics/pipe/smart/manifold4w/supply/visible/layer4,
/obj/effect/landmark/ert_shuttle_spawn,
/turf/open/floor/mineral/plastitanium,
/area/shuttle/phoenix/ert)
"DZ" = (
/obj/structure/chair/comfy/shuttle,
/turf/open/floor/pod,
/area/shuttle/phoenix/ert)
"Eb" = (
/obj/machinery/computer/aifixer{
	dir = 1
	},
/turf/open/floor/pod,
/area/shuttle/phoenix/ert)
"Er" = (
/turf/open/floor/pod,
/area/shuttle/phoenix/ert)
"Eu" = (
/obj/machinery/smartfridge/organ,
/turf/open/floor/pod/light,
/area/shuttle/phoenix/ert)
"FV" = (
/turf/template_noop,
/area/template_noop)
"FW" = (
/obj/structure/rack/gunrack,
/obj/item/gun/ballistic/shotgun/riot/sol/super/empty{
	icon_angle = 90;
	pixel_x = -2
	},
/obj/item/gun/ballistic/shotgun/riot/sol/super/empty{
	icon_angle = 90
	},
/obj/item/gun/ballistic/shotgun/riot/sol/super/empty{
	icon_angle = 90;
	pixel_x = -14
	},
/turf/open/floor/pod/light,
/area/shuttle/phoenix/ert)
"Ga" = (
/obj/machinery/atmospherics/components/unary/vent_scrubber/on/layer2{
	dir = 8
	},
/turf/open/floor/pod/light,
/area/shuttle/phoenix/ert)
"Gg" = (
/obj/machinery/door/airlock/multi_tile/metal{
	dir = 8;
	name = "Armory"
	},
/obj/effect/mapping_helpers/airlock/access/any/admin/general,
/obj/effect/mapping_helpers/airlock/cutaiwire,
/turf/open/floor/mineral/plastitanium/red,
/area/shuttle/phoenix/ert)
"Gl" = (
/obj/machinery/atmospherics/components/unary/passive_vent/layer2{
	dir = 4;
	name = "passive waste vent"
	},
/turf/open/floor/plating/reinforced/airless,
/area/template_noop)
"Gw" = (
/obj/machinery/door/airlock/hatch{
	name = "Medical Storage"
	},
/obj/machinery/atmospherics/pipe/smart/manifold4w/scrubbers/visible/layer2,
/obj/effect/mapping_helpers/airlock/cutaiwire,
/obj/machinery/atmospherics/pipe/smart/manifold4w/supply/visible/layer4,
/turf/open/floor/pod/light,
/area/shuttle/phoenix/ert)
"Hj" = (
/obj/machinery/computer/station_alert{
	dir = 1
	},
/turf/open/floor/pod,
/area/shuttle/phoenix/ert)
"HR" = (
/obj/machinery/atmospherics/components/unary/vent_pump/on/layer4{
	dir = 8
	},
/turf/open/floor/pod/light,
/area/shuttle/phoenix/ert)
"Ih" = (
/obj/machinery/door/airlock/external{
	id_tag = "phoenix_ert_exitbolts"
	},
/obj/effect/mapping_helpers/airlock/cutaiwire,
/obj/effect/mapping_helpers/airlock/cyclelink_helper,
/obj/effect/mapping_helpers/airlock/access/all/admin/general,
/turf/open/floor/plating/reinforced/airless,
/area/shuttle/phoenix/ert)
"JM" = (
/obj/structure/chair/comfy/shuttle{
	dir = 4
	},
/obj/effect/landmark/ert_shuttle_spawn,
/turf/open/floor/mineral/plastitanium,
/area/shuttle/phoenix/ert)
"KB" = (
/obj/machinery/door/airlock/external{
	id_tag = "phoenix_ert_exitbolts"
	},
/obj/effect/mapping_helpers/airlock/cutaiwire,
/obj/effect/mapping_helpers/airlock/cyclelink_helper{
	dir = 1
	},
/obj/effect/mapping_helpers/airlock/access/all/admin/general,
/obj/machinery/atmospherics/pipe/smart/manifold4w/scrubbers/visible/layer2,
/obj/machinery/scanner_gate/preset_guns,
/turf/open/floor/plating/reinforced/airless,
/area/shuttle/phoenix/ert)
"KR" = (
/obj/structure/closet/firecloset/wall{
	pixel_y = 32
	},
/turf/open/floor/mineral/plastitanium,
/area/shuttle/phoenix/ert)
"KT" = (
/obj/structure/table/reinforced,
/obj/item/tank/internals/emergency_oxygen/double{
	pixel_y = -4
	},
/obj/item/tank/internals/emergency_oxygen/double{
	pixel_y = 4
	},
/turf/open/floor/mineral/plastitanium,
/area/shuttle/phoenix/ert)
"LM" = (
/obj/structure/table/survival_pod,
/obj/item/surgery_tray/full/advanced,
/turf/open/floor/pod/light,
/area/shuttle/phoenix/ert)
"My" = (
/obj/structure/table/reinforced,
/obj/item/storage/box/flashbangs,
/turf/open/floor/pod/light,
/area/shuttle/phoenix/ert)
"MK" = (
/obj/machinery/recharger{
	pixel_x = -5;
	pixel_y = 4
	},
/obj/machinery/recharger{
	pixel_x = 5;
	pixel_y = 4
	},
/obj/structure/table/reinforced,
/turf/open/floor/mineral/plastitanium,
/area/shuttle/phoenix/ert)
"MR" = (
/obj/machinery/atmospherics/pipe/smart/manifold4w/scrubbers/visible/layer2,
/turf/open/floor/pod/light,
/area/shuttle/phoenix/ert)
"MV" = (
/obj/machinery/door/poddoor{
	id = "phoenix_ert_windows";
	name = "Window Blast Shutters"
	},
/obj/effect/spawner/structure/window/survival_pod,
/turf/open/floor/plating,
/area/shuttle/phoenix/ert)
"Nm" = (
/obj/machinery/rnd/production/circuit_imprinter/offstation{
	drop_direction = 8
	},
/turf/open/floor/plating/reinforced/airless,
/area/shuttle/phoenix/ert)
"Ny" = (
/obj/machinery/atmospherics/components/unary/vent_scrubber/on/layer2,
/turf/open/floor/plating/reinforced/airless,
/area/shuttle/phoenix/ert)
"NM" = (
/obj/structure/rack/shelf,
/obj/item/ammo_box/advanced/s12gauge/express{
	pixel_y = -6
	},
/obj/item/ammo_box/advanced/s12gauge/express{
	pixel_y = 6
	},
/turf/open/floor/pod/light,
/area/shuttle/phoenix/ert)
"OQ" = (
/obj/structure/table/abductor,
/turf/open/floor/mineral/plastitanium,
/area/shuttle/phoenix/ert)
"OU" = (
/obj/machinery/power/shuttle_engine/huge{
	dir = 1
	},
/turf/open/floor/plating/reinforced/airless,
/area/shuttle/phoenix/ert)
"Pf" = (
/obj/machinery/ore_silo,
/turf/open/floor/plating/reinforced/airless,
/area/shuttle/phoenix/ert)
"Pl" = (
/obj/machinery/door/airlock/multi_tile/metal{
	dir = 4;
	name = "Emergency Treatment Center"
	},
/obj/effect/mapping_helpers/airlock/cutaiwire,
/turf/open/floor/mineral/plastitanium/red,
/area/shuttle/phoenix/ert)
"PB" = (
/turf/open/floor/mineral/plastitanium,
/area/shuttle/phoenix/ert)
"PN" = (
/obj/machinery/door/airlock/highsecurity{
	name = "Right Engine Maintenance"
	},
/obj/effect/mapping_helpers/airlock/access/any/admin/general,
/obj/effect/mapping_helpers/airlock/unres{
	dir = 8
	},
/obj/effect/mapping_helpers/airlock/cutaiwire,
/turf/open/floor/mineral/plastitanium/red,
/area/shuttle/phoenix/ert)
"PY" = (
/obj/machinery/atmospherics/pipe/smart/manifold4w/supply/visible/layer4,
/turf/open/floor/pod,
/area/shuttle/phoenix/ert)
"PZ" = (
/obj/machinery/rnd/production/protolathe/offstation{
	drop_direction = 8
	},
/turf/open/floor/plating/reinforced/airless,
/area/shuttle/phoenix/ert)
"QA" = (
/obj/machinery/stasis/survival_pod,
/turf/open/floor/pod/light,
/area/shuttle/phoenix/ert)
"QR" = (
/obj/machinery/limbgrower/fullupgrade,
/turf/open/floor/pod/light,
/area/shuttle/phoenix/ert)
"SA" = (
/obj/item/storage/medkit/frontier/phoenix/oxygen/stocked{
	pixel_x = 6;
	pixel_y = 8
	},
/obj/item/storage/medkit/frontier/phoenix/oxygen/stocked{
	pixel_x = -6;
	pixel_y = 8
	},
/obj/structure/table/reinforced,
/obj/item/storage/medkit/frontier/phoenix/oxygen/stocked{
	pixel_y = 2
	},
/turf/open/floor/pod/light,
/area/shuttle/phoenix/ert)
"Tn" = (
/obj/machinery/power/shuttle_engine/heater{
	dir = 1
	},
/obj/structure/window/reinforced/plasma/spawner/directional/south,
/turf/open/floor/plating/reinforced/airless,
/area/shuttle/phoenix/ert)
"TQ" = (
/obj/machinery/atmospherics/pipe/smart/manifold4w/scrubbers/visible/layer2,
/obj/machinery/atmospherics/pipe/smart/manifold4w/supply/visible/layer4,
/turf/open/floor/pod/light,
/area/shuttle/phoenix/ert)
"UA" = (
/obj/machinery/atmospherics/components/unary/vent_scrubber/on/layer2{
	dir = 8
	},
/turf/open/floor/pod,
/area/shuttle/phoenix/ert)
"UO" = (
/obj/machinery/atmospherics/components/unary/portables_connector/visible/layer4{
	dir = 4;
	name = "atmos input tank connector"
	},
/turf/open/floor/plating/reinforced/airless,
/area/shuttle/phoenix/ert)
"Wv" = (
/obj/machinery/door/airlock/highsecurity{
	name = "Medical Bridge Access"
	},
/obj/effect/mapping_helpers/airlock/access/any/admin/captain,
/obj/effect/mapping_helpers/airlock/cutaiwire,
/obj/machinery/atmospherics/pipe/smart/manifold4w/scrubbers/visible/layer2,
/turf/open/floor/mineral/plastitanium/red,
/area/shuttle/phoenix/ert)
"Wy" = (
/obj/effect/spawner/structure/window/reinforced/plasma/plastitanium,
/turf/open/floor/mineral/plastitanium,
/area/shuttle/phoenix/ert)
"WC" = (
/obj/structure/rack/shelf,
/obj/item/ammo_box/magazine/pulse/extended/spawns_empty{
	pixel_x = -8
	},
/obj/item/ammo_box/magazine/pulse/extended/spawns_empty{
	pixel_x = -2
	},
/obj/item/ammo_box/magazine/pulse/extended/spawns_empty{
	pixel_x = 4
	},
/turf/open/floor/pod/light,
/area/shuttle/phoenix/ert)
"WE" = (
/obj/machinery/sleeper/self_control,
/obj/structure/window/reinforced/plasma/spawner/directional/west,
/turf/open/floor/pod,
/area/shuttle/phoenix/ert)
"Xv" = (
/obj/machinery/door/airlock/highsecurity{
	name = "Left Engine Maintenance"
	},
/obj/effect/mapping_helpers/airlock/access/any/admin/general,
/obj/effect/mapping_helpers/airlock/unres{
	dir = 4
	},
/obj/machinery/atmospherics/pipe/smart/manifold4w/supply/visible/layer4,
/obj/effect/mapping_helpers/airlock/cutaiwire,
/turf/open/floor/mineral/plastitanium/red,
/area/shuttle/phoenix/ert)
"XH" = (
/obj/machinery/sleeper/self_control,
/obj/structure/window/reinforced/plasma/spawner/directional/east,
/turf/open/floor/pod,
/area/shuttle/phoenix/ert)
"YK" = (
/obj/machinery/door/airlock/multi_tile/metal{
	dir = 4;
	name = "Emergency Treatment Center"
	},
/obj/machinery/atmospherics/pipe/smart/manifold4w/scrubbers/visible/layer2,
/obj/effect/mapping_helpers/airlock/cutaiwire,
/turf/open/floor/mineral/plastitanium/red,
/area/shuttle/phoenix/ert)
"YP" = (
/obj/machinery/mech_bay_recharge_port{
	dir = 1
	},
/turf/open/floor/plating/reinforced/airless,
/area/shuttle/phoenix/ert)
"Za" = (
/obj/machinery/door/airlock/multi_tile/metal{
	dir = 8;
	name = "Armory"
	},
/obj/effect/mapping_helpers/airlock/access/any/admin/general,
/obj/machinery/atmospherics/pipe/smart/manifold4w/scrubbers/visible/layer2,
/obj/effect/mapping_helpers/airlock/cutaiwire,
/turf/open/floor/mineral/plastitanium/red,
/area/shuttle/phoenix/ert)
"Zj" = (
/obj/machinery/door/airlock/highsecurity{
	name = "Shuttle Bridge"
	},
/obj/effect/mapping_helpers/airlock/access/any/admin/captain,
/obj/effect/mapping_helpers/airlock/unres,
/obj/effect/mapping_helpers/airlock/cutaiwire,
/obj/machinery/atmospherics/pipe/smart/manifold4w/supply/visible/layer4,
/turf/open/floor/mineral/plastitanium/red,
/area/shuttle/phoenix/ert)

(1,1,1) = {"
FV
FV
FV
FV
FV
FV
FV
rN
pm
pm
pm
pm
pm
pm
pm
rN
FV
FV
FV
FV
FV
FV
FV
"}
(2,1,1) = {"
FV
FV
FV
FV
FV
FV
rN
pm
LM
uk
QA
eG
LM
uk
QA
pm
rN
Gl
mE
rN
rN
mE
FV
"}
(3,1,1) = {"
FV
pm
pm
pm
pm
pm
pm
pm
CT
Bi
nW
eG
CT
Bi
nW
pm
pm
tk
tv
pm
pm
rN
FV
"}
(4,1,1) = {"
do
jF
OU
Tn
ih
PZ
Nm
pm
bS
MR
qX
eG
bS
MR
qX
pm
dy
jp
SA
Bf
pm
rN
FV
"}
(5,1,1) = {"
do
jF
jF
Tn
ih
mo
jF
pm
Af
iP
Af
Eu
Af
iP
Af
pm
dE
MR
Bi
oO
pm
mE
FV
"}
(6,1,1) = {"
do
jF
jF
Tn
ih
eU
jF
sT
nW
gE
MR
MR
MR
gE
TQ
Gw
TQ
MR
MR
wb
pm
mE
FV
"}
(7,1,1) = {"
do
jF
OU
Tn
ih
st
jF
pm
QR
oX
ir
oX
ir
oX
oX
pm
pm
pm
Wv
pm
pm
rN
FV
"}
(8,1,1) = {"
do
jF
jF
Tn
ih
ad
jF
pm
Wy
kC
YK
Wy
Ax
Pl
Wy
pm
zB
Er
UA
Er
Er
pm
rN
"}
(9,1,1) = {"
do
jF
jF
Tn
ih
Pf
mp
pm
xl
vP
jV
PB
jV
PB
uG
pm
zB
Er
DZ
Hj
Er
pm
rN
"}
(10,1,1) = {"
rN
pm
pm
pm
pm
pm
PN
pm
KR
vP
vp
JM
vp
PB
uG
pm
XH
Er
Er
Er
Er
Er
MV
"}
(11,1,1) = {"
pm
fq
ml
rd
pm
Di
PB
PB
PB
DT
uj
OQ
uj
PB
PB
BR
PY
PY
rp
Er
DZ
zM
MV
"}
(12,1,1) = {"
Ih
jF
Ny
ql
KB
jV
Aw
Aw
Aw
gt
uj
rj
uj
lv
PB
pm
PY
DZ
ok
Er
Er
tQ
MV
"}
(13,1,1) = {"
pm
rd
YP
mA
pm
KT
vP
PB
PB
DT
uj
OQ
hZ
vP
vP
Zj
PY
PY
rp
Er
DZ
gG
MV
"}
(14,1,1) = {"
rN
pm
pm
pm
pm
pm
Xv
pm
xl
vP
xt
nP
xt
vP
MK
pm
WE
Er
Er
Er
Er
Er
MV
"}
(15,1,1) = {"
do
jF
OU
Tn
ih
pT
dr
pm
KR
vP
jV
PB
jV
PB
MK
pm
zB
Er
DZ
Eb
Er
pm
rN
"}
(16,1,1) = {"
do
jF
jF
Tn
ih
lP
dr
pm
Wy
kC
Za
Wy
Ax
Gg
Wy
pm
zB
Er
iB
Er
Er
pm
rN
"}
(17,1,1) = {"
do
jF
jF
Tn
ih
ru
dr
pm
oX
oX
ir
oX
ir
oX
oX
pm
pm
pm
DK
pm
pm
rN
FV
"}
(18,1,1) = {"
do
jF
OU
Tn
ih
dr
dr
dk
oX
HR
MR
nW
MR
Dt
ir
nv
ir
ir
ir
nW
pm
mE
FV
"}
(19,1,1) = {"
do
jF
jF
Tn
ih
dr
UO
pm
nW
NM
MR
WC
MR
eo
nW
pm
HR
nW
Ga
nW
pm
mE
FV
"}
(20,1,1) = {"
do
jF
jF
Tn
ih
dr
mB
pm
nW
NM
MR
WC
MR
eo
nW
pm
gW
My
My
nn
pm
rN
FV
"}
(21,1,1) = {"
FV
pm
pm
pm
pm
pm
pm
pm
nW
NM
Ga
WC
Ga
eo
nW
pm
pm
tv
tv
pm
pm
rN
FV
"}
(22,1,1) = {"
FV
FV
FV
FV
FV
FV
rN
pm
nW
FW
nW
xC
nW
xC
nW
pm
rN
mE
mE
rN
rN
mE
FV
"}
(23,1,1) = {"
FV
FV
FV
FV
FV
FV
FV
rN
pm
pm
pm
pm
pm
pm
pm
rN
FV
FV
FV
FV
FV
FV
FV
"}
