//MAP CONVERTED BY dmm2tgm.py THIS HEADER COMMENT PREVENTS RECONVERSION, DO NOT REMOVE
"a" = (
/obj/effect/turf_decal/delivery/white,
/obj/effect/turf_decal/box/white{
	color = "#00FFFF"
	},
/obj/machinery/light/cold/directional/east,
/turf/open/floor/iron/shuttle/exploration,
/area/shuttle/phoenix/tradeship)
"b" = (
/obj/machinery/door/airlock/external{
	id_tag = "phoenix_tradership_exitbolts2"
	},
/obj/effect/mapping_helpers/airlock/access/any/admin/general,
/obj/effect/mapping_helpers/airlock/cyclelink_helper{
	dir = 1
	},
/obj/effect/mapping_helpers/airlock/cutaiwire,
/turf/open/floor/noslip,
/area/shuttle/phoenix/tradeship)
"c" = (
/obj/machinery/button/door/directional/east{
	name = "Exterior Bolt Control";
	id = "phoenix_tradership_exitbolts2";
	normaldoorcontrol = 1;
	specialfunctions = 4
	},
/turf/open/floor/noslip,
/area/shuttle/phoenix/tradeship)
"d" = (
/obj/machinery/computer/camera_advanced/shuttle_docker/phoenix/trader{
	dir = 1
	},
/turf/open/floor/pod/light,
/area/shuttle/phoenix/tradeship)
"e" = (
/obj/structure/chair/comfy/shuttle{
	dir = 8
	},
/turf/open/floor/pod/light,
/area/shuttle/phoenix/tradeship)
"h" = (
/obj/effect/turf_decal/delivery/white,
/obj/effect/turf_decal/box/white{
	color = "#CC9F00"
	},
/obj/structure/rack/shelf,
/obj/machinery/light/cold/directional/west,
/turf/open/floor/iron/shuttle/exploration,
/area/shuttle/phoenix/tradeship)
"l" = (
/obj/structure/cargo_shelf,
/obj/effect/turf_decal/delivery/white,
/obj/effect/turf_decal/box/white{
	color = "#CC9F00"
	},
/turf/open/floor/iron/shuttle/exploration,
/area/shuttle/phoenix/tradeship)
"n" = (
/obj/machinery/computer/shuttle/phoenix/trader{
	dir = 1
	},
/turf/open/floor/pod/light,
/area/shuttle/phoenix/tradeship)
"p" = (
/obj/effect/turf_decal/bot_red,
/obj/structure/tank_holder/extinguisher/advanced,
/turf/open/floor/iron/shuttle/cargo,
/area/shuttle/phoenix/tradeship)
"q" = (
/obj/effect/turf_decal/delivery/white,
/obj/effect/turf_decal/box/white{
	color = "#00FFFF"
	},
/turf/open/floor/iron/shuttle/exploration,
/area/shuttle/phoenix/tradeship)
"s" = (
/obj/structure/chair/comfy/shuttle,
/turf/open/floor/pod/light,
/area/shuttle/phoenix/tradeship)
"t" = (
/turf/open/floor/pod/light,
/area/shuttle/phoenix/tradeship)
"w" = (
/obj/structure/window/reinforced/plasma/spawner/directional/north{
	dir = 2
	},
/obj/machinery/power/shuttle_engine/heater{
	dir = 1
	},
/turf/open/floor/plating/airless,
/area/shuttle/phoenix/tradeship)
"x" = (
/obj/machinery/button/door/directional/north{
	normaldoorcontrol = 1;
	id = "phoenix_tradership_exitbolts2";
	name = "Exterior Bolt Control";
	specialfunctions = 4
	},
/turf/open/floor/pod/light,
/area/shuttle/phoenix/tradeship)
"z" = (
/obj/machinery/power/shuttle_engine/propulsion/left{
	dir = 1
	},
/turf/open/floor/plating/airless,
/area/shuttle/phoenix/tradeship)
"A" = (
/obj/effect/spawner/structure/window/reinforced/shuttle,
/turf/open/floor/plating,
/area/shuttle/phoenix/tradeship)
"E" = (
/obj/machinery/computer/camera_advanced{
	dir = 1
	},
/turf/open/floor/pod/light,
/area/shuttle/phoenix/tradeship)
"G" = (
/obj/machinery/door/airlock/external{
	id_tag = "phoenix_tradership_exitbolts2"
	},
/obj/effect/mapping_helpers/airlock/access/any/admin/general,
/obj/effect/mapping_helpers/airlock/cyclelink_helper,
/obj/docking_port/mobile{
	movement_force = list("KNOCKDOWN" = 0, "THROW" = 0);
	launch_status = 0;
	callTime = 150;
	shuttle_id = "phoenix_tradership";
	preferred_direction = 2;
	dir = 2;
	port_direction = 2;
	can_move_docking_ports = 1;
	name = "Phoenix Trade Shuttle";
	rechargeTime = 200
	},
/obj/effect/mapping_helpers/airlock/cutaiwire,
/turf/open/floor/noslip,
/area/shuttle/phoenix/tradeship)
"H" = (
/turf/closed/wall/mineral/titanium,
/area/shuttle/phoenix/tradeship)
"I" = (
/turf/closed/wall/mineral/titanium/nodiagonal,
/area/shuttle/phoenix/tradeship)
"J" = (
/obj/machinery/power/shuttle_engine/propulsion/right{
	dir = 1
	},
/turf/open/floor/plating/airless,
/area/shuttle/phoenix/tradeship)
"K" = (
/turf/closed/wall/mineral/titanium/spaceship/nodiagonal,
/area/shuttle/phoenix/tradeship)
"M" = (
/turf/template_noop,
/area/template_noop)
"S" = (
/obj/effect/turf_decal/bot_white,
/obj/structure/tank_dispenser,
/turf/open/floor/iron/shuttle/cargo,
/area/shuttle/phoenix/tradeship)
"U" = (
/obj/structure/chair/comfy/shuttle{
	dir = 4
	},
/turf/open/floor/pod/light,
/area/shuttle/phoenix/tradeship)
"W" = (
/turf/closed/wall/mineral/titanium/interior,
/area/shuttle/phoenix/tradeship)

(1,1,1) = {"
K
K
I
I
I
A
A
I
H
M
"}
(2,1,1) = {"
z
w
A
p
U
l
l
h
W
H
"}
(3,1,1) = {"
K
K
I
t
t
t
t
t
d
A
"}
(4,1,1) = {"
G
c
b
t
t
t
t
s
n
A
"}
(5,1,1) = {"
K
K
I
x
t
t
t
t
E
A
"}
(6,1,1) = {"
J
w
A
S
e
q
q
a
W
H
"}
(7,1,1) = {"
K
K
I
I
I
A
A
I
H
M
"}
